000000000000000000000000000000000000000000000000000000000
000000000000000000000000000000000000000000000000000000000
000000300000400500000000000000000000000000000000000000000
000000000000000000000000000000000000000000000000000000000
000000022222000000000000000000000000000000000000000000000
000000000000000000000000000000000000000000000022222220000
220000000000000002200000022000000000002000000011111110000
112222222222222221100002211200022222221222222200000000000
111111111111111111100001111100011111111100000000000000000
111111111111111111100000110000011111111100000000000000000
111111111111111111100000100000000000000000000000000000000
111111111111111111100000100000000000000000000000000000000
111111111111111111100000000000000000000000000000000000000